NO textures/png/north_texture.png
SO textures/png/south_texture.png
WE textures/png/west_texture.png
EA textures/png/east_texture.png

C 200,200,200
F 100,100,100

1111111111111111111111111111111111111
1000000000000000000000000000000000001
1001000000000000000000000000000001001
1001000000000000000000011100100001001
1001000111000000000000010000100001001
1001000000000000000000010011100001001
1001000000000000000000010000100001001
1001000000111000000000011100100001001
1001000000000000000000010000100001001
1001000000000011100000010011100001001
1001000000000000000000010000100001001
1001000000000000000000011100100001001
1001000000000000000000010000100001001
1001000000000000000000010011100001001
1001000000000000000000010000000001001
1001000000000000000000011111111111001
1000000000000000011110000000000000001
1001000000000000011110000000000001001
1000000000000000011110000000000000001
1001000000000000011110000000000001001
1001000000000000000000000000000001001
1001000000000000000000000000000001001
1001000000000000000000000000000001001
1001000000000000000000000000000001001
1001000000000000000000000000000001001
1001000000000000000000000000000001001
1001000000000000000000000000000001001
1001000000000000000000011100100001001
1001000111000000000000010000100001001
1001000000000000000000010011100001001
1001000000000000000000010000100001001
1001000000111000000000011100100001001
1001000000000000000000010000100001001
1001000000000011100000010011100001001
1001000000000000000000010000100001001
1001000000000000000000011100100001001
1001000000000000000000010000100001001
1001000000000000000000010011100001001
1001000000000000000000010000000001001
1001000000000000000000011111111111001
1000000000000000011110000000000000001
1001000000000000011110000000000001001
1000000000000000011110000000000000001
1001000000000000011110000000000001001
1001000000000000000000000000000001001
1001000000000000000000000000000001001
1001000000000000000000000000000001001
1001000000000000000000000000000001001
1001000000000000000000000000000001001
1001000000000000000000000000000001001
1001000000000000000000000000000001001
1001000000000000000000011100100001001
1001000111000000000000010000100001001
1001000000000000000000010011100001001
1001000000000000000000010000100001001
1001000000111000000000011100100001001
1001000000000000000000010000100001001
1001000000000011100000010011100001001
1001000000000000000000010000100001001
1001000000000000000000011100100001001
1001000000000000000000010000100001001
1001000000000000000000010011100001001
1001000000000000000000010000000001001
1001000000000000000000011111111111001
1000000000000000011110000000000000001
1001000000000000011110000000000001001
1000000000000000011110000000000000001
1001000000000000011110000000000001001
1001000000000000000000000000000001001
1001000000000000000000000000000001001
1001000000000000000000000000000001001
1001000000000000000000000000000001001
1001000000000000000000000000000001001
1001000000000000000000000000000001001
1001000000000000000000000000000001001
1001000000000000000000011100100001001
1001000111000000000000010000100001001
1001000000000000000000010011100001001
1001000000000000000000010000100001001
1001000000111000000000011100100001001
1001000000000000000000010000100001001
1001000000000011100000010011100001001
1001000000000000000000010000100001001
1001000000000000000000011100100001001
1001000000000000000000010000100001001
1001000000000000000000010011100001001
1001000000000000000000010000000001001
1001000000000000000000011111111111001
1000000000000000011110000000000000001
1001000000000000011110000000000001001
1000000000000000011110000000000000001
1001000000000000011110000000000001001
1001000000000000000000000000000001001
1001000000000000000000000000000001001
1001000000000000000000000000000001001
1001000000000000000000000000000001001
1001000000000000000000000000000001001
1001000000000000000000000000000001001
1001000000000000000000000000000001001
1001000000000000000000011100100001001
1001000111000000000000010000100001001
1001000000000000000000010011100001001
1001000000000000000000010000100001001
1001000000111000000000011100100001001
1001000000000000000000010000100001001
1001000000000011100000010011100001001
1001000000000000000000010000100001001
1001000000000000000000011100100001001
1001000000000000000000010000100001001
1001000000000000000000010011100001001
1001000000000000000000010000000001001
1001000000000000000000011111111111001
1000000000000000011110000000000000001
1001000000000000011110000000000001001
1000000000000000011110000000000000001
1001000000000000011110000000000001001
1001000000000000000000000000000001001
1001000000000000000000000000000001001
1001000000000000000000000000000001001
1001000000000000000000000000000001001
1001000000000000000000000000000001001
1001000000000000000000000000000001001
1001000000000000000000000000000001001
1001000000000000000000011100100001001
1001000111000000000000010000100001001
1001000000000000000000010011100001001
1001000000000000000000010000100001001
1001000000111000000000011100100001001
1001000000000000000000010000100001001
1001000000000011100000010011100001001
1001000000000000000000010000100001001
1001000000000000000000011100100001001
1001000000000000000000010000100001001
1001000000000000000000010011100001001
1001000000000000000000010000000001001
1001000000000000000000011111111111001
100000000000000001111000000000000000111111111111111111
100100000000000001111000000000000100000000000000010011
100000000000000001111000000000000000100000000000001001
100100000000000001111000000000000100000000000000010011
100100000000000000000000000000000100100000000000001001
100100000000000000000000000000000100100000000000001001
100100000000000000000000000000000100100000000000001001
100100000000000000000000000000000100100000000000001001
100100000000000000000000000000000100100000000000001001
100100000000000000000000000000000100000000000000010011
100100000000000000000000000000000100100000000000001001
100100000000000000000001110010000100000000000000010011
100100011100000000000001000010000100000000000000010011
100100000000000000000001001110000100000000000000010011
100100000000000000000001000010000100000000000000010011
100100000011100000000001110010000100000000000000010011
100100000000000000000001000010000100000000000000010011
100100000000001110000001001110000100000000000000010011
100100000000000000000001000010000100000000000000010011
100100000000000000000001110010000100000000000000010011
100100000000000000000001000010000100000000000000010011
100100000000000000000001001110000100000000000000010011
100100000000000000000001000000000100000000000000010011
100100000000000000000001111111111100000000000000010011
100000000000000001111000000000000000000000000000010011
100100000000000001111000000000000100000000000000010011
100000000000000001111000000000000000000000000000010011
100100000000000001111000000000000100000000000000010011
100100000000000000000000000000000100000000000000010011
100100000000000000S00000000000000100000000000000010011
100100000000000000000000000000000100000000000000010011
100100000000000000000000000000000100000000000000010011
100100000000000000000000000000000100000000000000010011
100100000000000000000000000000000100000000000000010011
100100000000000000000000000000000100000000000000010011
100100000000000000000001110010000100000000000000010011
100100011100000000000001000010000100100000000000001001
100100000000000000000001001110000100000000000000010011
100100000000000000000001000010000100000000000000010011
100100000011100000000001110010000100000000000000010011
100100000000000000000001000010000100000000000000010011
100100000000001110000001001110000100000000000000010011
100100000000000000000001000010000100000000000000010011
100100000000000000000001110010000100000000000000010011
100100000000000000000001000010000100000000000000010011
100100000000000000000001001110000100000000000000010011
100100000000000000000001000000000100000000000000010011
100100000000000000000001111111111100000000000000010011
100000000000000001111000000000000000000000000000010011
100100000000000001111000000000000100000000000000010011
100000000000000001111000000000000000000000000000010011
100100000000000001111000000000000100000000000000010011
100100000000000000000000000000000100000000000000010011
100100000000000000000000000000000100000000000000010011
100100000000000000000000000000000100000000000000010011
100100000000000000000000000000000100000000000000010011
100100000000000000000000000000000100000000000000010011
100100000000000000000000000000000100000000000000010011
100100000000000000000000000000000100000000000000010011
100100000000000000000000000000000100000000000000010011
100100000000000000000000000000000100000000000000010011
100100000000000000000000000000000100000000000000010011
100100000000000000000000000000000100000000000000010011
100100000000000000000000000000000100000000000000010011
100100011110000000000000111101000100000000000000010011
100100011110000000000000100001000100000000000000010011
100100011110000000000000100001000100000000000000010011
100100000000000000000000101111000100000000000000010011
100100000000000000000000000000000000000000000000010011
111111111111111111111111111111111111111111111111111111
