NO textures/png/north_texture.png
SO textures/png/south_texture.png
WE textures/png/west_texture.png
EA textures/png/east_texture.png

C 200,200,200
F 100,100,100

1111111111111111111111111111111111111
1001000000000000000000000000000001001
1001000000000000000000000000000001001
1001000000000000000000000000000001001
1001000000000000000000000000000001001
1001000000000000000000000000000001001
1001000000000000000000000000000001001
1000000000000000000000000000000000001
1000000000000000000000000000000000001
1000000000000000000000000000000000001
1000000000000000000W00000000000000001
1000000000000000000000000000000000001
1000000000000000000000000000000000001
1111111111111111111111111111111111111