NO textures/png/north_texture.png
SO textures/png/south_texture.png
WE textures/png/west_texture.png
EA textures/png/east_texture.png

C 200,200,200
F 100,100,100

11111111111111111111111111
10010000000000000000000101
10010000000000000000000101
10010000000000000000000101
10010000000000000000000101
10010000000000000000001001
10010000000000000000001001
10000000000000000000000001
10000000000000000000000001
10000000000000000000000001
1000000000000000W00000001
10000000000000000000000001
10000000000000000000000001
11111111111111111111111111