NO textures/test/north.png
SO textures/test/south.png
WE textures/test/west.png
EA textures/test/east.png

F 99,160,80
C 53,120,255

111111111111111111111
1000000000E0000000001
111111111111111111111
