   WE                            textures/wolfenstein/grey_stone.png
NO      textures/wolfenstein/purple_stone.png



SO textures/wolfenstein/red_brick.png

F      17,    38,     64

EA textures/wolfenstein/wood.png



C 218, 234, 235

1111111111111111111111111
10S01   10000100000000000111
10001100   00000000111111111
1000110000000000110001001
1000000000100000000001001
1111111111111111111111111
