NO textures/test/north.png
SO textures/test/south.png
WE textures/test/west.png
EA textures/test/east.png

F 20,20,20
C 200,200,200

 1111 111111 1
 11111111111
 10110000101
 11S100000 01
11101111111 
1101  11    
1111111    
10001        
 11101 1         
 10111 1
111  1  1
1 11 11101        
1001 1  1          
1111 111




