NO textures/test/north.png
SO textures/test/south.png
WE textures/test/west.png
EA textures/test/east.png

F 20,20,20
C 200,200,200

1111111
1010  01          
11S0    1                                       
10  10111                                         
1000 1      
1   11
10 001          
 1110011      
 101  1     
10  01  
11 0111   
10011101
111111111
