NO textures/test/north.png
SO textures/test/south.png
WE textures/test/west.png
EA textures/test/east.png

F 20,20,20
C 200,200,200

 111111
   100011
  10001
 10001
  1 01111
1000S 1      
1100  11
10001111
10001
10001
10001
10001
1111111
