NO textures/test/north.png
SO textures/test/south.png
WE textures/test/west.png
EA textures/test/east.png

F 20,20,20
C 200,200,200

 111111111
1010 1 001
11S0     1
10  10  1111    
1000  11    
1   11    
10 001        
 1110011         
 101  1
10  01
11 0111111        
1001110  1          
11111111