NO textures/test/north.png
SO textures/test/south.png
WE textures/test/west.png
EA textures/test/east.png

F 20,20,20
C 200,200,200

 111111
   100011
  10001
 10011
1101 11
10 S 1     
1101 111
10001111
1000001
1000001
1011101
11111 1
11111 1
