NO textures/test/north.png
SO textures/test/south.png
WE textures/test/west.png
EA textures/test/east.png

F 20,20,20
C 200,200,200

 111111111
10110100101
11S10000001
111011  1111    
1001  11    
111111    
10001        
 1110111         
 1011 1
111 11
111 111111        
100111  1          
11111111
