NO textures/test/north.png
SO textures/test/south.png
WE textures/test/west.png
EA textures/test/east.png

F 20,20,20
C 200,200,200

 1111  1
   101011
   100011
  10011
1101111
1000S1 11     
11011111
10001111
1000001
1000001
1010011
11111 1
11111 1
11111 1